1111111
1CE0P11
11CCC1111
1111111
