1111111111
1P00000001
1110111111
10000C0001
1011111E01
100C000001
1111111101
1000000C01
1C00000001
1111111111
